*******
*     *
*** * *
*   * *
* *** *
*     *
*******